{
  "name": "DZ60",
  "vendorProductId": 1146757728,
  "macros": ["", "", "", "", "", "", "", "", "", "", "", "", "", "", "", ""],
  "layers": [
    [
      "KC_GRV",
      "KC_1",
      "KC_2",
      "KC_3",
      "KC_4",
      "KC_5",
      "KC_6",
      "KC_7",
      "KC_8",
      "KC_9",
      "KC_0",
      "KC_MINS",
      "KC_EQL",
      "KC_GRV",
      "KC_BSPC",
      "KC_TAB",
      "KC_NO",
      "KC_Q",
      "KC_W",
      "KC_E",
      "KC_R",
      "KC_T",
      "KC_Y",
      "KC_U",
      "KC_I",
      "KC_O",
      "KC_P",
      "KC_LBRC",
      "KC_RBRC",
      "KC_BSLS",
      "MT(MOD_LGUI,KC_ESC)",
      "KC_NO",
      "KC_A",
      "KC_S",
      "KC_D",
      "KC_F",
      "KC_G",
      "KC_H",
      "KC_J",
      "KC_K",
      "KC_L",
      "KC_SCLN",
      "KC_QUOT",
      "KC_ENT",
      "KC_NO",
      "KC_LSFT",
      "KC_NUBS",
      "KC_Z",
      "KC_X",
      "KC_C",
      "KC_V",
      "KC_B",
      "KC_N",
      "KC_M",
      "KC_COMM",
      "KC_DOT",
      "KC_SLSH",
      "KC_RSFT",
      "MO(1)",
      "KC_RSFT",
      "KC_LCTL",
      "MO(1)",
      "KC_NO",
      "KC_LALT",
      "KC_F1",
      "KC_NO",
      "KC_SPC",
      "KC_NO",
      "KC_F2",
      "KC_NO",
      "KC_RGUI",
      "KC_RALT",
      "KC_RCTL",
      "KC_INS",
      "MO(2)"
    ],
    [
      "KC_ESC",
      "KC_F1",
      "KC_F2",
      "KC_F3",
      "KC_F4",
      "KC_F5",
      "KC_F6",
      "KC_F7",
      "KC_F8",
      "KC_F9",
      "KC_F10",
      "KC_F11",
      "KC_F12",
      "KC_TRNS",
      "KC_DEL",
      "KC_CAPS",
      "KC_NO",
      "KC_TRNS",
      "KC_TRNS",
      "KC_END",
      "KC_TRNS",
      "KC_TRNS",
      "KC_TRNS",
      "KC_PGUP",
      "KC_INS",
      "KC_TRNS",
      "KC_PSCR",
      "KC_TRNS",
      "KC_TRNS",
      "KC_TRNS",
      "KC_TRNS",
      "KC_NO",
      "KC_TRNS",
      "KC_SLCK",
      "KC_PGDN",
      "KC_TRNS",
      "KC_TRNS",
      "KC_LEFT",
      "KC_DOWN",
      "KC_UP",
      "KC_RGHT",
      "KC_TRNS",
      "KC_TRNS",
      "KC_TRNS",
      "KC_NO",
      "KC_TRNS",
      "KC_TRNS",
      "KC_MSTP",
      "KC_MPRV",
      "KC_MPLY",
      "KC_MNXT",
      "KC_HOME",
      "KC_TRNS",
      "KC_TRNS",
      "KC_VOLD",
      "KC_VOLU",
      "KC_MUTE",
      "KC_TRNS",
      "KC_TRNS",
      "KC_TRNS",
      "KC_TRNS",
      "KC_TRNS",
      "KC_NO",
      "KC_TRNS",
      "KC_TRNS",
      "KC_NO",
      "KC_TRNS",
      "KC_NO",
      "KC_TRNS",
      "KC_NO",
      "KC_TRNS",
      "KC_TRNS",
      "KC_TRNS",
      "KC_PAUS",
      "KC_TRNS"
    ],
    [
      "RESET",
      "KC_TRNS",
      "KC_TRNS",
      "KC_TRNS",
      "KC_TRNS",
      "KC_TRNS",
      "KC_TRNS",
      "KC_TRNS",
      "KC_TRNS",
      "KC_TRNS",
      "KC_TRNS",
      "KC_TRNS",
      "KC_TRNS",
      "S(KC_NO)",
      "KC_TRNS",
      "KC_TRNS",
      "C(KC_NO)",
      "KC_TRNS",
      "KC_TRNS",
      "KC_TRNS",
      "KC_TRNS",
      "KC_TRNS",
      "KC_TRNS",
      "KC_TRNS",
      "KC_TRNS",
      "KC_TRNS",
      "KC_TRNS",
      "KC_TRNS",
      "KC_TRNS",
      "KC_TRNS",
      "KC_CAPS",
      "LAG(KC_B)",
      "KC_TRNS",
      "KC_SYSREQ",
      "KC_TRNS",
      "KC_TRNS",
      "KC_TRNS",
      "KC_TRNS",
      "KC_TRNS",
      "KC_TRNS",
      "KC_TRNS",
      "KC_TRNS",
      "KC_TRNS",
      "RGB_TOG",
      "KC_NO",
      "KC_TRNS",
      "C(KC_R)",
      "KC_TRNS",
      "KC_TRNS",
      "KC_TRNS",
      "KC_TRNS",
      "KC_TRNS",
      "KC_TRNS",
      "KC_TRNS",
      "KC_TRNS",
      "KC_TRNS",
      "KC_TRNS",
      "KC_NO",
      "KC_TRNS",
      "KC_TRNS",
      "KC_TRNS",
      "KC_TRNS",
      "KC_NO",
      "KC_TRNS",
      "LCA(KC_NO)",
      "C(G(KC_TRNS))",
      "KC_TRNS",
      "KC_NO",
      "LCA(KC_B)",
      "RCTL(RGUI(KC_D))",
      "KC_TRNS",
      "KC_TRNS",
      "KC_TRNS",
      "KC_TRNS",
      "KC_TRNS"
    ],
    [
      "KC_TRNS",
      "KC_TRNS",
      "KC_TRNS",
      "KC_TRNS",
      "KC_TRNS",
      "KC_TRNS",
      "KC_TRNS",
      "KC_TRNS",
      "KC_TRNS",
      "KC_TRNS",
      "KC_TRNS",
      "KC_TRNS",
      "KC_TRNS",
      "MT(MOD_LCTL | MOD_LALT | MOD_RCTL | MOD_RALT,KC_B)",
      "KC_TRNS",
      "KC_TRNS",
      "MT(MOD_LCTL | MOD_LALT | MOD_RCTL | MOD_RALT,KC_TRNS)",
      "KC_TRNS",
      "KC_TRNS",
      "KC_TRNS",
      "KC_TRNS",
      "KC_TRNS",
      "KC_TRNS",
      "KC_TRNS",
      "KC_TRNS",
      "KC_TRNS",
      "KC_TRNS",
      "KC_TRNS",
      "KC_TRNS",
      "KC_TRNS",
      "KC_TRNS",
      "KC_NO",
      "KC_TRNS",
      "KC_TRNS",
      "KC_TRNS",
      "KC_TRNS",
      "KC_TRNS",
      "KC_TRNS",
      "KC_TRNS",
      "KC_TRNS",
      "KC_TRNS",
      "KC_TRNS",
      "KC_TRNS",
      "KC_TRNS",
      "G(KC_LANG6)",
      "KC_TRNS",
      "S(KC_NO)",
      "KC_TRNS",
      "KC_TRNS",
      "KC_TRNS",
      "KC_TRNS",
      "KC_TRNS",
      "KC_TRNS",
      "KC_TRNS",
      "KC_TRNS",
      "KC_TRNS",
      "KC_TRNS",
      "KC_NO",
      "KC_TRNS",
      "KC_TRNS",
      "KC_TRNS",
      "KC_TRNS",
      "MT(MOD_LCTL | MOD_LALT | MOD_RCTL | MOD_RALT,KC_B)",
      "KC_TRNS",
      "KC_NO",
      "MT(MOD_LCTL | MOD_LALT | MOD_RCTL | MOD_RALT,KC_TRNS)",
      "KC_TRNS",
      "KC_NO",
      "S(KC_F)",
      "KC_P3",
      "KC_TRNS",
      "KC_TRNS",
      "KC_TRNS",
      "KC_TRNS",
      "KC_TRNS"
    ]
  ],
  "encoders": []
}